1111111111111111111111111111111111
1000000000000000000000000000000001
100000000C000000000000000000000001
1000000000000000000000000000000001
1000000000000000000000000000000001
1000000000000000000000000000000001
100000000000E000000000000000000001
1000000000000000000000000000000000
1000000000000000000000000000000000
100000000000000000000P000000000001
1000000000000000000000000000000001
1000000000C00000000000000000000001
1000000000000000000000000000000001
1000000000000000000000000000000001
1000000000000000000000000C00000001
1000000000000000000000000000000001
1000000000000000000000000000000001
1111111111111111111111111111111111