11111111111111111111111111111111
10000000000000000000000000000001
1000P00000000000000000000000C001
10000000000000000000000000000001
11111111111111111100001111111111
10000000000000000100001000000001
10C00000000000E001000010C0000001
10000000000000000100001000000001
10000111111111111100001111100001
10000000000000000000000000000001
10000000000000000000000000000001
10000000000000000000000000000001
11111111000011111111111111100001
10000000000010000000000000000001
100C0000000010000000000000000001
10000000000010000000000000000001
11111111111110000111111111111111
10000000000000000000000000000001
10CC000000000000000000000000CC01
10CC000000000000000000000000CC01
10000000000000000000000000000001
10000001111111111111111000011111
10000000100000000000010000000001
10000000010000CC0000100000000001
10000000001000000001000000000001
10000000000100000010000000000001
10000000000010000100000000000001
10000000000000000000000000000001
11111111111111111111111111111111
