11111111111111
10000C11111111
11101111111111
1000P0000E1111
11111111111111