1111111111111
1000000000001
1000000C00001
1000000000001
1000P00000001
1000000000E01
1111111111111